10
10
XXXXXXXXXX
X___@____X
X_$____$_X
X____$___X
XXXXX$XXXX
X________X
X_M______X
X________X
X__MM___MX
XXXXXXXXXX