14
14
XXXXXXXXXXXXXX
XX_____@_____X
XX_$_$_$_$_$_X
X___$_$_$_$__X
X__$_$_$_$_$_X
XXXXXXX$XXXXXX
XXXXXX_M___XXX
XXXXXXMMXM_XXX
XXXXXX_MMM_XXX
XXXXX__M_MM_XX
XXXXX_MMMMM_XX
XXXXXXXXXXXXXX
XXXXXXXXXXXXXX
XXXXXXXXXXXXXX